   ***********************
   *    *           *
   *   *            *
   *  *             *
   * *              *
   **            *     *
   *             *     *
   *                *
   *                *
   *                *
   *                *
   *                *
   *                *
   *                *
   *                *
   *
   *
   *
   *
   *
******************************