   ***********************
   *    *            *
   *   *             *
   *  *              *
   * *               *
   **
   *
   *
   *
   *
   *
   *
   *
   *
   *
   *
   *
   *
   *
   *
******************************