   ***********************
   *    *           *
   *   *            *
   *  *             *
   * *              *
   **            *     *
   *             *     *
   *                *
   *                *     
   *        ***     *     ***
   *           *    *    *
   *            *********
   *                *
   *                *
   *                *
   *           *         *
   *           *         *
   *           *         *
   *           *         *
   *
******************************